{
  "version":"21.01.001",
  "mapname":"undefined",
  "height": "30",
  "width": "30",
  "fog":"#88aacc 8 16",
  "light": "5",
  "water_level": "1.05",
  "x" : 9,
  "y" : 24,
  "direction" : 1,
  "fielddata":[
    0,  0,  0,  0,  0,  0,  0,  0,  0,  0,  0,  0,  0,  0,  0,  0,  0,  0,  0, 35, 35, 35, 35,  0,  0,  0,  0,  0,  0,  0,
    0,  0,  0,  0,  0, 35, 35, 35, 35, 35, 35, 35, 35, 35, 35, 35, 35, 35, 35, 35,  5,  5, 35, 35, 35, 35, 35,  0,  0,  0,
    0,  0,  0, 35, 35, 35,  6,  6,  6,  6,  6,  6,  6,  6, 89, 89, 89,  6,  6, 35,  5, 35, 35, 53,  6,  6, 35,  0,  0,  0,
    0, 35, 35, 35,  6,  6,  6, 89,  6, 35,  6,  6, 89, 53,  6,  6, 53, 53,  6, 35,  5,  5, 53, 53, 89,  6, 35, 35, 35,  0,
    0, 35,  6,  6,  6, 89, 53, 53, 53, 35, 89,  6,  6, 53,  6,  6, 53, 53, 53, 89, 89, 35, 53, 53,  6, 89, 89, 89, 35,  0,
    0, 35,  6, 89, 53, 53, 53,  6,  6, 35,  6, 53, 89, 53,  6,  6, 53, 53, 53, 53,  6, 35,  6, 53, 53, 53, 53,  6, 35, 35,
    0, 35,  6, 37, 37, 53, 53, 89,  6, 35,  6, 53, 53, 53, 89,  6, 53,  6,  6, 53, 53, 35, 89, 53,  6,  6, 53,  6, 35, 35,
    0, 35,  6, 37, 37, 53, 53, 53, 35, 35, 89, 53,  6, 89,  6, 53, 53, 53, 53, 53, 53, 35, 89, 53,  6, 89, 53,  6, 35,  0,
    0, 35,  6,  6, 89,  6, 89, 53, 53, 53, 53, 53, 53,  6,  6, 53,  6,  6, 89, 53, 89, 35,  6, 53,  6, 89, 53,  6, 35,  0,
    0, 35,  6,  6,  6,  6,  6, 53,  6,  6, 53,  6,  6, 89,  6, 53,  6, 89,  6, 53, 53, 53, 53, 53, 53,  6, 53, 89, 35,  0,
    0, 35, 89,  6,  6, 53, 53, 53,  6, 89, 53,  6, 89, 53, 53, 53, 53,  6, 89, 89, 35, 35, 35, 35,  6,  6, 53, 89, 35,  0,
    0, 35, 89, 53, 53, 53, 89,  6, 89,  6, 53, 53, 53, 53, 35, 35, 53, 53, 53, 53, 53, 53, 53, 35,  6,  6, 53, 89, 35,  0,
    0, 35, 89, 53, 53,  6, 89, 53, 53, 53, 53,  6,  6, 35, 35, 35, 53, 53,  6, 53, 53,  6,  6, 35, 53, 53, 53, 89, 35,  0,
    0, 35,  6, 53, 53,  6, 35, 35, 35, 35, 35, 35, 35, 35, 35, 89, 53, 53,  6, 53, 53,  6, 89, 35,  6,  6,  6,  6, 35,  0,
    0, 35,  6,  6, 53, 53, 53,  6,  6, 89,  6, 53, 53, 53, 53, 53, 53,  6, 89, 53, 53, 53, 53,  6, 89, 53, 89,  6, 35,  0,
    0, 35, 35, 89,  6, 89, 53, 53, 53, 89, 89, 53,  6,  6, 89,  6, 53, 89, 35, 35, 35,  6, 53, 53, 53, 53,  6,  6, 35,  0,
    0,  0, 35,  6,  6,  6,  6, 89, 53, 53, 53, 53, 89,  6, 89,  6, 53, 53, 53,  6, 35, 89, 53,  6, 53,  6,  6,  6, 35,  0,
    0,  0, 35, 35, 35, 35, 89,  6, 53, 53, 35, 35, 35, 35,  6, 89, 53, 53, 53, 53, 35,  6, 89,  6, 53, 89,  6,  6, 35,  0,
    0, 35, 35,  6,  6,  6, 89, 35, 53, 53,  6, 89,  6, 35, 53, 53, 53, 53, 53,  6, 35, 35, 35, 35, 53, 89,  6, 89, 35,  0,
    0, 35,  6,  6, 89,  6, 89,  6, 53, 89, 89,  6,  6, 35, 35, 53, 53, 53, 53,  6, 35,118, 53,  6, 53,  6, 89, 35, 35,  0,
    0, 35,  6,  6, 89, 89,  6, 89, 53,  6,  6,  6, 89,  6, 35,  6,  6, 53,  6,  6, 35, 53, 53, 53, 53,  6,  6, 35,  0,  0,
    0, 35, 35,  6,  6,  6,  5,  5,  5,  5,  5,  6,  6,  6, 35,  6,  6, 53, 89,  6,  6, 53, 53, 53,  6,  6, 89, 35,  0,  0,
    0, 35,  6,  6,  6,  6,  5,  5,  5,  5,  5,  6, 89,  6, 35,  6, 89, 53, 53, 53, 89, 89,  6,  6,  6,  6,  6, 35,  0,  0,
    0, 35,  6, 89,  6, 89,  5,  5,  5,  5,  5, 89,  6,  6, 35,  6,  6,  6, 89,  6,  6,  6, 89,  6,  6, 89,  6, 35,  0,  0,
    0, 35,  6,  6,  6,  6,  5,  5,  5,  5,  5,  6, 89, 35, 35, 35, 35, 35, 35, 35, 35, 35, 35, 35, 35, 35, 35, 35,  0,  0,
    0, 35,  6, 89, 89,  6,  5,  5,  5,  5,  5, 89,  6, 35,  0,  0,  0,  0,  0,  0,  0,  0,  0,  0,  0,  0,  0,  0,  0,  0,
    0, 35, 35,  6, 89,  6, 89,  6, 89,  6,  6, 89,  6, 35,  0,  0,  0,  0,  0,  0,  0,  0,  0,  0,  0,  0,  0,  0,  0,  0,
    0,  0, 35, 35,  6,  6,  6, 89,  6,  6,  6, 35, 35, 35,  0,  0,  0,  0,  0,  0,  0,  0,  0,  0,  0,  0,  0,  0,  0,  0,
    0,  0,  0, 35, 35, 35, 35,  6,  6,  6,  6, 35,  0,  0,  0,  0,  0,  0,  0,  0,  0,  0,  0,  0,  0,  0,  0,  0,  0,  0,
    0,  0,  0,  0,  0,  0, 35, 35, 35, 35, 35, 35,  0,  0,  0,  0,  0,  0,  0,  0,  0,  0,  0,  0,  0,  0,  0,  0,  0,  0
  ],
  "mobs":[
    {"id":"19","x":6,"y":5,"life":"4"},
    {"id":"19","x":19,"y":11,"life":"4"},
    {"id":"19","x":19,"y":17,"life":"4"},
    {"id":"19","x":24,"y":20,"life":"4"},
    {"id":"19","x":9,"y":12,"life":"4"},
    {"id":"114","x":16,"y":5,"life":"5"},
    {"id":"114","x":17,"y":19,"life":"5"},
    {"id":"94","x":5,"y":11,"life":"4"},
    {"id":"94","x":24,"y":9,"life":"4"},
    {"id":"114","x":20,"y":13,"life":"5"}
  ],
  "token":[
    {"id":"179","x":22,"y":4},
    {"id":"179","x":7,"y":21},
    {"id":"69","x":9,"y":25},
    {"id":"40","x":20,"y":2},
    {"id":"88","x":18,"y":18},
    {"id":"31","x":18,"y":16}
  ],
  "quest":{"event":"","filter":"","amount":"","template":{"en":"","de":""}},
  "introtext": {"de":"","en":""}
}