{
        "version":"23.04.001",
        "mapname":"undefined",
        "height": "30",
        "width": "30",
        "fog":"#88aacc 8 16",
        "light": "5",
        "water_level": "1.05",
        "x" : 13,
        "y" : 9,
        "direction" : 1,
        "fielddata":[
              0,  0,  0,  0,  0,  0,  0,  0,  0,  0,  0,  0,  0,  0,  0,  0,  0,  0,  0,  0,  0,  0,  0,  0,  0,  0,  0,  0,  0,  0,
              0,  0,  0,  0,  0,  0,  0,  0,  0,  0,  0,  0,  0,  0,  0,  0,  0,  0,  0,  0,  0,  0,  0,  0,  0,  0,  0,  0,  0,  0,
              0,  0,  0,  0,  0,  0,  0,  0,  0,  0,  0,  0,  0,  0,  0,  0,  0,  0,  0,  0,  0,  0,  0,  0,  0,  0,  0,  0,  0,  0,
              0,  0,  0,  0,  0,  0,  0,  0,  0,  0,  0,  0,  0,  0,  0,  0,  0,  0,  0,  0,  0,  0,  0,  0,  0,  0,  0,  0,  0,  0,
              0,  0,  0,  0,  0,  0,  0,  0,  0,  0,  0,  0,  0,  0,  0,  0,  0,  0,  0,  0,  0,  0,  0,  0,  0,  0,  0,  0,  0,  0,
              0,  0,  0,  0,  0,  0,  0,  0,  0, 91, 91, 91, 91, 91, 91,  0,  0,  0,  0,  0,  0,  0,  0,  0,  0,  0,  0,  0,  0,  0,
              0,  0,  0,  0,  0,  0,  0,  0, 91, 91, 92, 92, 92, 92, 91, 91, 91,  0,  0,  0,  0,  0,  0,  0,  0,  0,  0,  0,  0,  0,
              0,  0,  0,  0,  0,  0,  0,  0, 91, 92, 92, 92, 92, 92, 92, 92, 91,  0,  0,  0,  0,  0,  0,  0,  0,  0,  0,  0,  0,  0,
              0,  0,  0,  0,  0,  0,  0,  0, 91, 92, 92, 92, 92, 92, 92, 92, 91,  0,  0,  0,  0,  0,  0,  0,  0,  0,  0,  0,  0,  0,
              0,  0,  0,  0,  0,  0,  0,  0, 91, 92, 92, 92, 92, 92, 92, 92, 91,  0,  0,  0,  0,  0,  0,  0,  0,  0,  0,  0,  0,  0,
              0,  0,  0,  0,  0,  0,  0,  0, 91, 92, 92, 92, 92, 92, 92, 92, 91,  0,  0,  0,  0,  0,  0,  0,  0,  0,  0,  0,  0,  0,
              0,  0,  0,  0,  0,  0,  0,  0, 91, 91, 92, 92, 92, 92, 92, 91, 91,  0,  0,  0,  0,  0,  0,  0,  0,  0,  0,  0,  0,  0,
              0,  0,  0,  0,  0,  0,  0,  0, 91, 92, 92, 92, 92, 92, 92, 92, 91,  0,  0,  0,  0,  0,  0,  0,  0,  0,  0,  0,  0,  0,
              0,  0,  0,  0,  0,  0,  0,  0, 91, 92, 92, 92, 92, 92, 92, 92, 91, 91, 91, 91, 91, 91,  0,  0,  0,  0,  0,  0,  0,  0,
              0,  0,  0,  0,  0,  0,  0,  0, 91, 92, 92, 92, 92, 92, 92, 92, 91, 92, 92, 92, 92, 91,  0,  0,  0,  0,  0,  0,  0,  0,
              0,  0,  0,  0,  0,  0,  0,  0, 91, 91, 91, 91, 92, 91, 91, 91, 91, 92, 92, 92, 92, 91,  0,  0,  0,  0,  0,  0,  0,  0,
              0,  0,  0,  0,  0,  0,  0,  0,  0, 91, 92, 92, 92, 92, 92, 92, 92, 92, 92, 92, 92, 91,  0,  0,  0,  0,  0,  0,  0,  0,
              0,  0,  0,  0,  0,  0,  0,  0,  0, 91, 92, 92, 92, 92, 92, 92, 92, 92, 92, 92, 91, 91,  0,  0,  0,  0,  0,  0,  0,  0,
              0,  0,  0,  0,  0,  0,  0,  0,  0, 91, 92, 92, 92, 92, 92, 92, 92, 92, 92, 92, 91,  0,  0,  0,  0,  0,  0,  0,  0,  0,
              0,  0,  0,  0,  0,  0,  0,  0,  0, 91, 91, 91, 91, 91, 91, 91, 91, 91, 91, 91, 91,  0,  0,  0,  0,  0,  0,  0,  0,  0,
              0,  0,  0,  0,  0,  0,  0,  0,  0,  0,  0,  0,  0,  0,  0,  0,  0,  0,  0,  0,  0,  0,  0,  0,  0,  0,  0,  0,  0,  0,
              0,  0,  0,  0,  0,  0,  0,  0,  0,  0,  0,  0,  0,  0,  0,  0,  0,  0,  0,  0,  0,  0,  0,  0,  0,  0,  0,  0,  0,  0,
              0,  0,  0,  0,  0,  0,  0,  0,  0,  0,  0,  0,  0,  0,  0,  0,  0,  0,  0,  0,  0,  0,  0,  0,  0,  0,  0,  0,  0,  0,
              0,  0,  0,  0,  0,  0,  0,  0,  0,  0,  0,  0,  0,  0,  0,  0,  0,  0,  0,  0,  0,  0,  0,  0,  0,  0,  0,  0,  0,  0,
              0,  0,  0,  0,  0,  0,  0,  0,  0,  0,  0,  0,  0,  0,  0,  0,  0,  0,  0,  0,  0,  0,  0,  0,  0,  0,  0,  0,  0,  0,
              0,  0,  0,  0,  0,  0,  0,  0,  0,  0,  0,  0,  0,  0,  0,  0,  0,  0,  0,  0,  0,  0,  0,  0,  0,  0,  0,  0,  0,  0,
              0,  0,  0,  0,  0,  0,  0,  0,  0,  0,  0,  0,  0,  0,  0,  0,  0,  0,  0,  0,  0,  0,  0,  0,  0,  0,  0,  0,  0,  0,
              0,  0,  0,  0,  0,  0,  0,  0,  0,  0,  0,  0,  0,  0,  0,  0,  0,  0,  0,  0,  0,  0,  0,  0,  0,  0,  0,  0,  0,  0,
              0,  0,  0,  0,  0,  0,  0,  0,  0,  0,  0,  0,  0,  0,  0,  0,  0,  0,  0,  0,  0,  0,  0,  0,  0,  0,  0,  0,  0,  0,
              0,  0,  0,  0,  0,  0,  0,  0,  0,  0,  0,  0,  0,  0,  0,  0,  0,  0,  0,  0,  0,  0,  0,  0,  0,  0,  0,  0,  0,  0
        ],
        "mobs":[
            {
              "id":"186","x":12,"y":13,"life":"3","movement":"scripted",
              "waypoints":[
                { "eventfilter":"yummy1", "x":12, "y":17 },
                { "eventfilter":"yummy2", "x":18, "y":17 }
              ]
            }
        ],
        "token":[
            {"id":"95","x":11,"y":11,"action": {"type":"pick", "event":"movement", "filter": "yummy1" }},
            {"id":"95","x":11,"y":14,"action":{"type":"pick", "event":"movement", "filter": "yummy2" }}
        ],
        "quest":{"event":"","filter":"","amount":"","template":{"en":"","de":""}},
        "introtext": {"de":"","en":""}
    }