{ "x" : "1", "y" : "1", "mapname":"m_1x1.map", "fielddata":[
 4 ,3 ,6 ,4 ,3 ,4 ,3 ,3 ,3 ,5 ,4 ,3 ,3 ,6 ,6 ,4 ,5 ,3 ,5 ,6 ,3 ,4 ,3 ,5 ,3 ,6 ,4 ,5 ,6 ,3 
,6 ,2 ,2 ,2 ,2 ,2 ,2 ,2 ,2 ,2 ,2 ,2 ,2 ,2 ,2 ,2 ,2 ,2 ,2 ,2 ,2 ,2 ,2 ,2 ,2 ,2 ,2 ,2 ,2 ,3 
,6 ,2 ,2 ,2 ,6 ,7 ,7 ,2 ,2 ,2 ,7 ,2 ,2 ,7 ,2 ,2 ,2 ,7 ,2 ,2 ,2 ,2 ,2 ,2 ,2 ,2 ,2 ,2 ,2 ,5 
,5 ,2 ,2 ,2 ,6 ,2 ,2 ,2 ,2 ,2 ,2 ,2 ,2 ,7 ,2 ,2 ,2 ,11,11,11,2 ,2 ,7 ,7 ,7 ,7 ,7 ,2 ,2 ,3 
,3 ,2 ,2 ,2 ,2 ,2 ,2 ,2 ,2 ,2 ,2 ,2 ,2 ,7 ,2 ,2 ,2 ,11,11,11,7 ,2 ,7 ,2 ,2 ,2 ,7 ,2 ,2 ,6 
,4 ,2 ,2 ,4 ,2 ,2 ,2 ,2 ,2 ,3 ,2 ,2 ,2 ,7 ,2 ,2 ,2 ,11,11,11,7 ,2 ,7 ,2 ,7 ,7 ,7 ,2 ,2 ,3 
,6 ,2 ,2 ,4 ,4 ,5 ,4 ,2 ,2 ,5 ,2 ,2 ,2 ,7 ,7 ,7 ,7 ,2 ,2 ,2 ,5 ,2 ,7 ,2 ,2 ,2 ,2 ,2 ,2 ,4 
,5 ,2 ,2 ,2 ,2 ,2 ,2 ,2 ,2 ,3 ,2 ,2 ,2 ,2 ,2 ,2 ,2 ,2 ,2 ,2 ,5 ,2 ,7 ,7 ,7 ,2 ,2 ,2 ,2 ,6 
,3 ,2 ,2 ,2 ,2 ,2 ,2 ,2 ,2 ,2 ,2 ,2 ,2 ,2 ,2 ,2 ,2 ,2 ,2 ,2 ,7 ,2 ,2 ,2 ,2 ,2 ,2 ,2 ,2 ,4 
,4 ,2 ,2 ,7 ,12,12,12,7 ,7 ,7 ,2 ,2 ,2 ,2 ,7 ,7 ,6 ,3 ,5 ,7 ,7 ,2 ,2 ,2 ,2 ,2 ,2 ,2 ,2 ,3 
,3 ,2 ,2 ,5 ,12,12,12,2 ,2 ,2 ,2 ,2 ,2 ,2 ,2 ,2 ,2 ,2 ,2 ,2 ,2 ,2 ,2 ,2 ,7 ,7 ,7 ,2 ,2 ,4 
,6 ,2 ,2 ,5 ,12,12,12,2 ,8 ,8 ,8 ,8 ,2 ,8 ,2 ,2 ,9 ,9 ,9 ,10,10,10,13,13,13,2 ,2 ,2 ,2 ,6 
,4 ,2 ,2 ,7 ,2 ,7 ,2 ,2 ,8 ,2 ,2 ,2 ,2 ,2 ,2 ,2 ,2 ,2 ,2 ,2 ,2 ,2 ,2 ,2 ,13,2 ,2 ,2 ,2 ,3 
,3 ,2 ,2 ,2 ,2 ,7 ,2 ,2 ,8 ,2 ,2 ,2 ,8 ,8 ,2 ,2 ,9 ,9 ,9 ,10,10,10,13,13,13,2 ,2 ,2 ,2 ,3 
,6 ,3 ,3 ,3 ,3 ,3 ,4 ,5 ,8 ,8 ,8 ,8 ,8 ,3 ,4 ,3 ,3 ,3 ,3 ,3 ,5 ,3 ,4 ,6 ,3 ,3 ,5 ,3 ,6 ,3 
,3 ,3 ,3 ,3 ,3 ,3 ,3 ,3 ,3 ,3 ,3 ,3 ,3 ,3 ,3 ,3 ,3 ,3 ,3 ,3 ,3 ,3 ,3 ,3 ,3 ,3 ,3 ,3 ,3 ,3 
,3 ,3 ,3 ,3 ,3 ,3 ,3 ,3 ,3 ,3 ,3 ,3 ,3 ,3 ,3 ,3 ,3 ,3 ,3 ,3 ,3 ,3 ,3 ,3 ,3 ,3 ,3 ,3 ,3 ,3 
,3 ,3 ,3 ,3 ,3 ,3 ,3 ,3 ,3 ,3 ,3 ,3 ,3 ,3 ,3 ,3 ,3 ,3 ,3 ,3 ,3 ,3 ,3 ,3 ,3 ,3 ,3 ,3 ,3 ,3 
,3 ,3 ,3 ,3 ,3 ,3 ,3 ,3 ,3 ,3 ,3 ,3 ,3 ,3 ,3 ,3 ,3 ,3 ,3 ,3 ,3 ,3 ,3 ,3 ,3 ,3 ,3 ,3 ,3 ,3 
,3 ,3 ,3 ,3 ,3 ,3 ,3 ,3 ,3 ,3 ,3 ,3 ,3 ,3 ,3 ,3 ,3 ,3 ,3 ,3 ,3 ,3 ,3 ,3 ,3 ,3 ,3 ,3 ,3 ,3 
,3 ,3 ,3 ,3 ,3 ,3 ,3 ,3 ,3 ,3 ,3 ,3 ,3 ,3 ,3 ,3 ,3 ,3 ,3 ,3 ,3 ,3 ,3 ,3 ,3 ,3 ,3 ,3 ,3 ,3 
,3 ,3 ,3 ,3 ,3 ,3 ,3 ,3 ,3 ,3 ,3 ,3 ,3 ,3 ,3 ,3 ,3 ,3 ,3 ,3 ,3 ,3 ,3 ,3 ,3 ,3 ,3 ,3 ,3 ,3 
,3 ,3 ,3 ,3 ,3 ,3 ,3 ,3 ,3 ,3 ,3 ,3 ,3 ,3 ,3 ,3 ,3 ,3 ,3 ,3 ,3 ,3 ,3 ,3 ,3 ,3 ,3 ,3 ,3 ,3 
,3 ,3 ,3 ,3 ,3 ,3 ,3 ,3 ,3 ,3 ,3 ,3 ,3 ,3 ,3 ,3 ,3 ,3 ,3 ,3 ,3 ,3 ,3 ,3 ,3 ,3 ,3 ,3 ,3 ,3 
,3 ,3 ,3 ,3 ,3 ,3 ,3 ,3 ,3 ,3 ,3 ,3 ,3 ,3 ,3 ,3 ,3 ,3 ,3 ,3 ,3 ,3 ,3 ,3 ,3 ,3 ,3 ,3 ,3 ,3 
,3 ,3 ,3 ,3 ,3 ,3 ,3 ,3 ,3 ,3 ,3 ,3 ,3 ,3 ,3 ,3 ,3 ,3 ,3 ,3 ,3 ,3 ,3 ,3 ,3 ,3 ,3 ,3 ,3 ,3 
,3 ,3 ,3 ,3 ,3 ,3 ,3 ,3 ,3 ,3 ,3 ,3 ,3 ,3 ,3 ,3 ,3 ,3 ,3 ,3 ,3 ,3 ,3 ,3 ,3 ,3 ,3 ,3 ,3 ,3 
,3 ,3 ,3 ,3 ,3 ,3 ,3 ,3 ,3 ,3 ,3 ,3 ,3 ,3 ,3 ,3 ,3 ,3 ,3 ,3 ,3 ,3 ,3 ,3 ,3 ,3 ,3 ,3 ,3 ,3 
,3 ,3 ,3 ,3 ,3 ,3 ,3 ,3 ,3 ,3 ,3 ,3 ,3 ,3 ,3 ,3 ,3 ,3 ,3 ,3 ,3 ,3 ,3 ,3 ,3 ,3 ,3 ,3 ,3 ,3 
,3 ,3 ,3 ,3 ,3 ,3 ,3 ,3 ,3 ,3 ,3 ,3 ,3 ,3 ,3 ,3 ,3 ,3 ,3 ,3 ,3 ,3 ,3 ,3 ,3 ,3 ,3 ,3 ,3 ,3 ],
    "mobs":[
        {
            "x":44,
            "y":42,
            "MobID":"rat_001"
        }
    ]
    
}